airplane : avion  
airport : aéroport  
apple : pomme  
baby : bébé  
beach : plage  
beauty : beauté  
bed : lit  
bicycle : vélo  
bird : oiseau  
book : livre  
bread : pain  
butter : beurre  
camera : appareil photo  
candle : bougie  
car : voiture  
cat : chat  
chair : chaise  
cheese : fromage  
city : ville  
clock : horloge  
cloud : nuage  
coffee : café  
computer : ordinateur  
cow : vache  
cup : tasse  
dance : danse  
door : porte  
drink : boisson  
earth : terre  
egg : œuf  
elephant : éléphant  
family : famille  
fire : feu  
fish : poisson  
flower : fleur  
forest : forêt  
friend : ami  
garden : jardin  
gift : cadeau  
glass : verre  
grass : herbe  
guitar : guitare  
hair : cheveux  
hand : main  
hat : chapeau  
heart : cœur  
house : maison  
island : île  
jewelry : bijou  
key : clé  
king : roi  
kitchen : cuisine  
lamp : lampe  
letter : lettre  
love : amour  
map : carte  
milk : lait  
mirror : miroir  
money : argent  
moon : lune  
mountain : montagne  
music : musique  
necklace : collier  
night : nuit  
notebook : cahier  
ocean : océan  
orange : orange  
pen : stylo  
phone : téléphone  
pillow : oreiller  
rain : pluie  
river : rivière  
road : route  
sand : sable  
school : école  
sea : mer  
sheep : mouton  
shirt : chemise  
shoe : chaussure  
snow : neige  
soap : savon  
song : chanson  
star : étoile  
stone : pierre  
street : rue  
sugar : sucre  
sun : soleil  
table : table  
tea : thé  
telephone : téléphone  
television : télévision  
time : temps  
towel : serviette  
tree : arbre  
umbrella : parapluie  
village : village  
wall : mur  
water : eau  
window : fenêtre  
world : monde  
zoo : zoo  
